1111111111111
110000C000C01
1110011111101
1000C10000001
100011000C001
1000110000001
1000110000001
1P0011E000001
1111111111111