1111111111111
1111111111111
1E111111111C1
1000011111001
1000000111001
1000000001001
1P00000000001
1000000000001
1000000000001
1000000000001
1111111111111
