1111111111111111111111111111111111
1P0000000000000C00000C0000000001C1
1010010100100000101001000000010001
1010010010101110001001000000010011
1C0000000C00C1000000000000000000E1
1111111111111111111111111111111111
